11111111111111111111
11111111111111111111
1P000000000100000011
111100000001000000E1
11000000C00100000001
11000000000100000011
100000X0000100000011
1100C000C0X0C0111111
1111000000000X000001
100000000C0000000001
11111111111111111111