11111111111111111
11111111111111111
1C0111110X0000C01
11000000000000001
110000P010000X001
11C0X0100000000E1
11111111111111111