11111111111111111111
1P000000000100000011
11110000000100000001
11000000C00100000001
1100000000E100000011
100000X00000011
1100C000C0X111
1111000000000X000001
100000000C0000000001
11111111111111111111